5 10
|--------|
|.#.|..-.|
|..-|.@..|
|......-.|
|--------|