9 15
|-------------|
|#............|
|....o|.|o....|
|.----|.|----.|
|......@......|
|.----|.|----.|
|....o|.|o....|
|...........#.|
|-------------|