5 10
|--------|
|.#.|....|
|...|.@..|
|#.......|
|--------|